NOMBRE	CICLO
Pepe	SMX
Jose	DAW
Miguel	ASIR
Ana	SMX
Sara	SMX
Elena	DAW
Juan	ASIR
Andres	SMX
Jorge	DAW
Yago	ASIR
Tamara	SMX
Rafael	SMX
Federico	DAW
David	ASIR
Pablo	SMX
Arjun	DAW
Anand	ASIR
Rajesh	SMX
Mohan	SMX
John	DAW
Denial	ASIR
Williams	SMX
Dario	DAW
Luis	ASIR
Alberto	SMX
Celia	SMX
Bartolo	DAW
Nuncio	ASIR
Manuel	SMX
Xavi	DAW
